10
10
1
12
12:13
14
12,12,12,12,12,12,12,12,12,12
12,10,10,10,12,10,12,10,12,12
12,10,12,10,12,10,10,10,10,12
12,10,10,10,10,10,10,10,12,12
12,12,12,10,12,12,10,10,10,12
12,12,10,10,10,12,12,10,12,12
12,10,10,10,10,10,10,10,10,12
12,10,12,10,12,12,10,12,10,12
12,10,10,10,10,10,14,10,10,12
12,12,12,12,12,12,12,12,12,12